"filename", "language", "Java", "Markdown", "comment", "blank", "total"
"c:\JavaProjects\Sudoku\README.md", "Markdown", 0, 38, 0, 6, 44
"c:\JavaProjects\Sudoku\src\sudoku\Cell.java", "Java", 63, 0, 21, 5, 89
"c:\JavaProjects\Sudoku\src\sudoku\CellStatus.java", "Java", 8, 0, 6, 0, 14
"c:\JavaProjects\Sudoku\src\sudoku\DifficultySelectListener.java", "Java", 57, 0, 19, 19, 95
"c:\JavaProjects\Sudoku\src\sudoku\GameBoardPanel.java", "Java", 235, 0, 87, 47, 369
"c:\JavaProjects\Sudoku\src\sudoku\MainMenuPanel.java", "Java", 62, 0, 9, 20, 91
"c:\JavaProjects\Sudoku\src\sudoku\Puzzle.java", "Java", 85, 0, 35, 27, 147
"c:\JavaProjects\Sudoku\src\sudoku\SudokuConstants.java", "Java", 5, 0, 5, 0, 10
"c:\JavaProjects\Sudoku\src\sudoku\SudokuDifficulty.java", "Java", 4, 0, 0, 2, 6
"c:\JavaProjects\Sudoku\src\sudoku\SudokuMain.java", "Java", 45, 0, 31, 18, 94
"c:\JavaProjects\Sudoku\src\sudoku\SudokuMenu.java", "Java", 62, 0, 12, 21, 95
"Total", "-", 626, 38, 225, 165, 1054